Length=2
KeyCode=ABWGDE&VZIJKLMNOPRSTUFHCYX"'abwgdevzijklmnoprstufhcyx"'
Prompt=
ConstructPhrase=
[Data]
A	А
B	Б
V	В
G	Г
G'	Ґ
D	Д
E	Е
E'	Є
ZH	Ж
Zh	Ж
Z	З
I	І
Ji	Ї
JI	Ї
Y	И
J	Й
K	К
L	Л
M	М
N	Н
O	О
P	П
R	Р
S	С
T	Т
U	У
F	Ф
H	Х
C	Ц
CH	Ч
Ch	Ч
Sh	Ш
SH	Ш
Sj	Щ
SJ	Щ
''	Ь
JU	Ю
Ju	Ю
Ja	Я
JA	Я
"	'
a	а
b	б
v	в
g	г
g'	ґ
d	д
e	е
e'	є
zh	ж
z	з
i	і
ji	ї
y	и
j	й
k	к
l	л
m	м
n	н
o	о
p	п
r	р
s	с
t	т
u	у
f	ф
h	х
c	ц
ch	ч
sh	ш
sj	щ
'	ь
ju	ю
ja	я